# Language file for DE
[Widgets]
windowTitle = Fahrplananzeige

chooseStation = Bahnhof wählen
departure = Abfahrt
arrival = Ankunft
earlier = Früher
later = Später
now = Jetzt
request = Anfragen
refresh = Aktualisieren
previous = Vorherige
next = Nächste
showMap = Karte anzeigen
width = Breite
height = Höhe
hours = Stunden

ICE = ICE/TGV
IC = IC/EC
other = Other

from = Von
to = Nach
time = Uhrzeit
name = Zugnummer
track = Gleis
stop = Ort

[Menu]
colour = Farbe
application = Anwendung
quit = Beenden
change_Path = Pfad-Farbe ändern
change_Marker = Marker-Farbe ändern
select_Path = Pfad-Farbe wählen
select_Marker = Marker-Farbe wählen

[Labels]
on = am
for = für
off = von
route = Zugverlauf



