# Language file for DE
[Widgets]
windowTitle = Timetable

chooseStation = Choose Station
departure = Departure
arrival = Arrival
earlier = Earlier
later = Later
now = Now
request = Request
refresh = Refresh
previous = Previous
next = Next
showMap = Show Map
width = Width
height = Height
hours = Hours

ICE = ICE/TGV
IC = IC/EC
other = Other

from = From
to = To
time = Time
name = Name
track = Track
stop = Location

[Menu]
colour = Colour
application = Application
quit = Quit
change_Path = Change Path-Colour
change_Marker = Change Marker-Colour
select_Path = Select Path-Colour
select_Marker = Select Marker-Colour

[Labels]
on = on
for = for
off = off
route = Travel Route


